1 2 4
G
4
0 -1 2 -1 4 -1 7 -1
2
2 0,0,1 3 0,1,0
O
2
1 1 3 -1
3
0 0,0,0 2 0,0,2 3 0,1,1
G
3
4 -1 5 -1 6 -1
3
0 0,0,1 1 99,99,99 2 0,0,3
B
3
0 -1 1 -1 7 -1
2
0 0,0,2 3 0,1,3
B
2
0 -1 4 3
2
1 0,0,0 2 0,1,1
Y
2
2 -1 5 -1
2
0 0,1,0 1 0,0,1
O
4
2 0 3 -1 5 6 7 -1
1
2 0,1,3
G
3
0 -1 4 -1 5 -1
2
0 0,1,2 1 0,0,3
0,0,1
0,1,3